アルッテの町	阿鲁迪亚镇
アルッテ	阿鲁迪亚
セクンドゥム坑	塞肯多姆废坑
セクンドゥム	塞肯多姆
オルディウム神殿	奥鲁荻姆神殿
オルディウム	奥鲁荻姆
金の森	金暗之森
ロアルタ村	罗亚鲁塔村
ロアルタ	罗亚鲁塔
星降りの里	星降之里
クリスタルバレ`	水晶峡谷
アルッテw行	阿鲁迪亚飞机场
w行	飞机场
浮[大イルバ`ド	浮游大陆伊尔巴特
浮[大	浮游大陆
イルバ`ド	伊尔巴特
アウロン大塔	奥伦大铁塔
アウロン	奥伦
大塔	大铁塔
ム`ンブリア城	蒙布利亚城
ム`ンブリア	蒙布利亚
星ヶ峰	星之峰
ルナ＝ムンドゥス	月・异世界
メルセデク	梅尔塞迪克
海魔の庭	海魔庭院
Ｇ－コロッセオ	Ｇ－斗技场
コロッセオ	斗技场
魔女の家	魔女之家
ブランデ`ヶ丘	布兰迪山丘
ブランデ`ヶ	布兰迪
ギルドへ	猎人公会
ペンネ	芬尼
アルジェス	阿尔杰斯
セルペンティナ	塞尔芬迪纳
グランヴァレン	库朗毕林
トリスタン	特里斯坦
ケ`ニッヒ	康尼锡商
ヴァレンス家	瓦伦斯家
アルバトロス社	艾路毕查斯社
エアロテック	飞机
ロックフェラ`	洛克菲勒
ロ`ド．ヴァレンス号	罗德・瓦伦斯号
ベイオウルフ号	碧奥鲁夫号
．コア	・核心
地x	地虫
o	龙
の	暗之
金色の	金色
金色的魔王	金色魔王
	战
魔使い	魔剑使者
月の楣	月之战鬼
}大将	圣讨大将军
I狼狩り	饿狼狩猎者
い忍者	忍者实习生
	纯
殛L淌	战斗管家
覆面超人	蒙面超人
~究Oo	绝对究极无敌
阿鲁提	阿鲁迪
．Y	・里
^	馆
のg	之间
ブティック	布迪克
．曰诓课	・忏悔室
L	长
ペットショップ	宠物店
L	风
よろず屋	杂货店
脱衣所	更衣室
L	温泉
スキ`	滑雪场
坑．	废坑・
始まりの坑道	起始匝道
@	继
	场
．K点	・终点
クモのz	蜘蛛巢
ゴ`レム工房	格雷姆工房
艋	梦幻
迷m	迷宫
．入口	・入口
の}域	之圣域
祭への道	祭坛之道
の祭	之祭坛
@	园
の	之
．最奥	・最深处
区画	区域
道	轨道
Bjk	连接站
礼堂	礼拜堂
．祭	・祭坛
吹雪ヶ原	暴雪平原
の参道	剑术山道
施O	设施
	废弃
	异
x	驹
C	机
	剑
	卷
町・	村・
．	・
	铁
}	圣
L技场	斗技场
ミュ`ジアム	斗技场
o	馆
ミュジアム	斗技场
宿酒场	熊猫楼
